###################
#........#.....x..#
#.##.###.#.###.##.#
#..x..............#
#.##.#.#####.#.##.#
#....#...#...#....#
####.###.#.###.####
---#.#.......#.#---
####.#.##-##.#.####
----...#-G-#...----
####.#.#####.#.####
---#.#...P...#.#---
####.#.#####.#.####
#........#........#
#.##.###.#.###.##.#
#..#...........#..#
##.#.#.#####.#.#.##
#..x.#...#...#..x.#
#.######.#.######.#
#.................#
###################
