###################
---------G-#-------
####-#-#####-#-####
---#-#-------#-#---
####-#-#####-#-####
#--....._#_.....--#
#-##-###_#_###_##-#
#--#--........_#--#
##-#-#-#####_#_#-##
#--x_#---#--P#----#
#-######-#-######-#
#-...............-#
###################
