############################
#............##............#
#.####.#####.##.#####.####.#
#x####.#####.##.#####.####x#
#.####.#####.##.#####.####.#
#..........................#
#.####.##.########.##.####.#
#.####.##.########.##.####.#
#......##....##....##......#
######.#####_##_#####.######
_____#
_____#
_____#
######
w_____
######
_____#
_____#
_____#
######
